#################################################################################
# #   #         #                   #   #         #       #             #       #
# # # # ### ### ######### ######### # ##### ##### ##### # # ####### ### # ##### #
#   #     #   # #         # #     # #   #   #   #       # # #       # # # #   # #
############# # # ######### # ### # ### # ### # # ####### ### ####### # # # # # #
#           # #   # #     #   #   #   # # # # #   #   #       #       # # # # # #
# ######### # ##### # # # # ### ##### # # # # ##### # ######### ### ### ### # # #
# #         #   #   # # # #   #     # # # #   # #   #       #     # #   #   #   #
# ######### # # ### # # ##### ### # # # # # ### # ######### ##### # # ### ##### #
# #       # # #   #   # #     # # # #   # #     # #     # #   #   #       #   # #
# # ##### # # ### ##### # ##### # # ### # ####### ### # # ### # ########### # # #
#   #   # # #   #     # #       # # #   #     #   #   #     # # #   #   #   #   #
##### # # # ######### # ####### # ### ####### # ### ######### ### # # # # #######
#     #   # #         #       # #   # # #     # #     #       #   # # # # #     #
# ######### # ######### ### ### ### # # # ### # # ### # ####### ### # ### # ### #
#   # #     #   #     # # #   # # #     #   # # #   # #   #   #   # # #   #   # #
### # # ##### # # # ### # ### # # ##### ### ### ##### ### # # # ### # # ##### # #
#   #   #     # # # #   #   #     #   # #   #           # # #   #   #       # # #
# ### ######### # # # ### # ##### # # ### ### ########### # ##### ######### ### #
# #             # #       # #   # # #   # #   # #       #       # #   #     #   #
# # ############# ######### # # ### ### # # ### # ##### # ####### # # # ##### # #
# # #           # # # #     # #     #   # #     #   # # # # #   # # # # #     # #
# ### ######### # # # ####### ####### ### ##### ### # # # # ### # # # # ##### # #
#     #   #     #   #         #     #   #     #   #   # #     # #   # # #     # #
# ##### # # ####### ########### ####### # ####### ### # ### ### ##### # # ##### #
#     # # #   #   # #       #         # #   #       # # #   #   #     # # #   # #
####### # ### # ### # ##### # ##### ### # # # ####### # ##### ### ##### # ### # #
#       # #   #     # #   # #   # #     # # # # #     #   #   #   #     #   # # #
# ####### # # ##### # ### # ### # ####### # # # # ####### # ### # ### ##### # # #
# # #     # # #   # #   # #   #   # #   # #   # #     # #   #   #   #       #   #
# # # ##### # # # ##### # ### ### # # # # ##### ##### # ##### ##### ######### ###
# #   #     # # # #   #   # # #   #   # # #   #     #   # #   #   #     #   # # #
# ### ### # ### # # # ### # # # ####### # # # ##### ### # # ### # ##### ### # # #
#   #   # # #   # # #   # # # # #       #   #         # #   #   # #   #   # #   #
# # ### # # # ### # ### # # # # ### ### ########### ### # ### ### ### ### # ### #
# #   # # # #   #   #   # # # #     #   #   #     # #   #     #     # #   #   # #
# ### # # ##### ##### # # # # ####### ### # ##### # # ############# # # ### # # #
#   # #   #   #     # # # # # #   #   # # #       # # #   #   #   #   # # # #   #
### # ##### # ##### # ### # # # # # ### # ######### # # # # # # # ##### # # #####
#   #       #       #       #   #                   #   #   #   #       #       #
#################################################################################
